111111111111111111
1001001000000000C1
11000C000C0000C001
1CP011010M0000E001
111111111111111111