1111111111111
1E010000M00C1
1000011111001
1P00110000001
1111111111111