1111111
1000C01
1C01011
1000011
10P00E1
1111111