1111111111111111111111111111111111
10M000000000000C00000C00000M000001
10100101001000001010010M0000010101
1E10010M10101010001001000000010101
1P0000000C00C0000000000M00000000C1
1111111111111111111111111111111111