11111111111111111
100000100000M0001
10000010000100001
10000000000001001
100P00C0000000001
10000010000100001
10000010000100001
10000010C00100001
100000100001000E1
11111111111111111