1111111111111111111111111111111111
1EM000000000000C00000C00000M000001
10100101001000001010010M0000010101
1010010M10101010001001000000010101
1P0000000C00C0000000000000000000C1
1111111111111111111111111111111111